NO ./textures/
SO ./textures/
WE ./textures/
EA ./textures/

F 220, 100, 0
C 225, 500, 0

111111111
100010001
100010001
1000N0001
100000001
111111111
