NO ./textures/
SO ./textures/
WE ./textures/
EA ./textures/

F 220, 100, 0
C 225, 500, 0

111111111
100010001
100011111
100000001
100000001
100000001
100000001
100000001
100000001
10000N001
111111111
