NO ./textures/
SO ./textures/
WE ./textures/
EA ./textures/

F 220, 100, 0
C 225, 30, 0

11111111111111111111111111111111111111
10000000000000011100000000000000000001
10000000000000011100000000000000000001
10000000000000011100000000000000000001
10000000000000011100000000000000000001
10000000000000011100000000000000000001
10000000000000011100000000000000000001
10000000000000011100000000000000000001
10000000000000000000000000000000000001
10000000000000000000000000000000000001
10000000000000000000000000000000000001
10000N00000000000001111111111111111111
10000000000000000001111111111111111111
10000000000000000000000000000000000001
10000000000000000000000000000000000001
10000000000000000000000000000000000001
10000000000000000000000000000000000001
10000000000000000000000000000000000001
10000000000000000000000000000000000001
10000000000000000000000000000000000001
11111111111111111111111111111111111111
